***********
*p  xxx  m*
* +x+ +x+ *
*x  xxx  x*
*x+ +x+x+ *
*  xx xx  *
* +x+x+ +x*
*  xx xx  *
*x+x+x+ #/#####
* x  xx <&&XX&#
*#/#****#X-X-X#
!#&#!!!!#&XX&&#
*#\#****#X-X-X#
* x  xx <&&XX&#
*x+x+x+ #\#####
*  xx xx  *
* +x+x+ +x*
*  xx xx  *
*x+ +x+x+ *
*x  xxx  x*
* +x+ +x+ *
*b  xxx  c*
***********