*************
*           *
* p       b *
*  +  x  +  *
*           *
*    #/#    *
*    <&>    *
*    #\#    *
*           *
*  +  x  +  *
* m       c *
*           *
*************