***********
*  pxxx   *
* +x+ +x+ *
*   xxx   *
*x+ +x+x+ *
*  xx xx  *
* +x+x+ + *
*  xx xx  *
*x+x+x+ #/#####
* x  xx <&MXX&#
*#/#****#X-X-X#
!#&#!!!!#&XX&&#
*#\#****#X-X-X#
* x  xx <&&XX&#
*x+x+x+ #\#####
*  xx xx  *
* +x+x+ +x*
*  xx xx  *
*x+ +x+x+ *
*x  xxx  x*
* +x+ +x+c*
* b xxx   *
***********

